[
  {

  "type": "map",
  "playerx": 0,
  "playery": 0,
  "xsize": 16,
  "ysize": 16,
  "slices": [
    [
      "::::::::::::::::",
      ":11111111111111:",
      ":11111111111111:",
      ":11111111111111:",
      ":11111111111111:",
      ":21111111111111:",
      ":11111111111111:",
      ":11311111111111:",
      ":11131111111111:",
      ":11121111111111:",
      ":11111111111111:",
      ":11111111111111:",
      ":11311111111111:",
      ":11111111111111:",
      ":11111111111111:",
      "::::::::::::::::"
    ],
    [
      "                ",
      "                ",
      "                ",
      "    --------    ",
      "    --------    ",
      "    --------    ",
      "    --------    ",
      "    --------    ",
      "    --------    ",
      "    --------    ",
      "    --------    ",
      "    --------    ",
      "    --------    ",
      "                ",
      "                "
    ]
  ],
  "lighting": [
    {"x": 16, "y": -16, "strength": 15}
  ]
}
]